BBBBBBBBBBBBBBBBBBBBBBBBBBBBBBBBBBBBBBBB
B                                      B
B                                      B
B                               WWWW   B
BBBBBBBBBBBBBBBBBBBBBB          W  W   B
B                               W  W   B
B                               W  W   B
B                         WWWWBBBBBBB  B
B                        WWWWBBBBBBBB  B
B                  BBBBWWWWWBBBBBBBBB  B
B                 BBBBWWWWWBBBBBBBBBB  B
B                BBBBBBWWWWWBBBBBBBBB  B
B               BBBBBBBBBWWWWBBBBBBBB  B
B              BBBBBBBBBBWWWWWBBBBBBB  B
BWWWWWWWWWWWWWBBBBBBBBBBBWWWWWWWWBBBB  B
B              BBBBBBBBBBBWWWWWWWWBBB  B
B             BBBBB         WWW        B
B            BBBB        BBBWWWB       B
BWWWWWWWWWWWWBB        BBBBBWWWBB      B
B                    BBBBBBBWWWBBB     B
B                  BBBBBBBBBWWWBBBB    B
BB               BBBBBBBBBBBWWWBBBBB   B
B              BBBBBBBBBBBBBWWWBBBBBB  B
B           WWWWWWWWWWWWWWWWWWWWWWWWW  B
B         BBBBBBBBBBBBBBBBBBBBBBBBBBB  B
BB      BBBBBBBBBBBBBBBBBBBBBBBBBBBBB  B
BBB                            BBBBBB  B
BBBB                           BBBBBB  B
BBBBBBBBBBBBBBB          BBBBBBBBBBBB  B
B    BBBBBBBBBBBB         BBBBBBBBBBB  B
B     BBBBBBBBBBBBB       BBBBBBBBBB   B
BB            BBBBBBB       BBBBBBB    B
BBB            BBBBBBBB   BBBBBBB      B
BBB                                    B
BBBBBBBBBBBBBBBBBBBBBBBBBBBBBBBBBBBBBBBB