BBBBBBBBBBBBBBBBBBBBBBBB
B                      B
B                      B
B                      B
BBBBBBBBBBBBBB         B
B                      B
B                      B
B                      B
B                      B
B                      B
B                      B
B     BBB              B
B                      B
B                      B
B                      B
B                      B
B                      B
B           B          B
B                      B
B                      B
B                      B
B                      B
B                      B
B               B     BB
B                      B
B                      B
B                      B
B       BB             B
B                      B
B                      B
B                      B
B                      B
B                      B
B                      B
B             BB       B
B                      B
B                      B
B                      B
B                      B
B                      B
B                      B
B       BB             B
B                      B
B                      B
B                      B
B                      B
B                      B
B                      B
B             BB       B
B                      B
B                      B
B                      B
B                      B
B                      B
B     BBB              B
B                      B
B                      B
B                      B
B                      B
B                      B
B           B          B
B                      B
B                      B
B                      B
B                      B
B                      B
B               B     BB
B                      B
B                      B
B                      B
B       BB             B
B                      B
B                      B
B                      B
B                      B
B                      B
B                      B
B             BB       B
B                      B
B                      B
B                      B
B                      B
B                      B
B                      B
B       BB             B
B                      B
B                      B
B                      B
B                      B
B                      B
B                      B
B             BB       B
B                      B
B                      B
B                      B
B                      B
B                      B
B                      B
B                      B
BBBBBBBBBBBBBBBBBBBBBBBB