BBBBBBBBBBBBBBBBBBBBBBBBBBBBBBBBBBBBBBBBBBBBBBBBBBBBBBBBBBBBBBBBBBBBBBBBBBBBB
B                                                                           B
B                                                                           B
B                                                                           B
B                                 BBBBBBBB                                  B
B                                                                           B
B                                                                           B
B                                 BBBB           BBBBBB                     B
B                                                BB                         B
B                       BBBBBB                   BB                         B
B                                                BB                         B
B                 BB                             BB                         B
B               BBBBBB                           BB                         B
BBBBBBBBBBBBBBBBBBBBBBBBBBBBBBBBBBBBBBBBBBBBBBBBBBBBBBBBBBBBBBBBBBBBBBBBBBBBB