BBBBBBBBBBBBBBBBBBBBBBBBBBBBBBBBBBBBBBBB
B                  B                   B
B                  B                   B
B                  B                   B
B                                      B
BBBBBB                                 B
B                                      B
B                    BBBBB    BBBBBBB  B
B                   BBBBB    BBBBBBBB  B
B                  BBBB     BBBBBBBBB  B
B                 BBBB     BBBBBBBBBB  B
B                BBBBBB     BBBBBBBBB  B
B               BBBBBBBB     BBBBBBBB  B
B              BBBBBBBBBB     BBBBBBB  B
BBBBBBBBBBBBBBBBBBBBBBBBB        BBBB  B
B              BBBBBBBBBBB        BBB  B
B             BBBBB                    B
B            BBBB        BBB   B       B
BBBBBBBBBBBBBBB        BBBBB   BB      B
B                    BBBBBBB   BBB     B
B                  BBBBBBBBB   BBBB    B
BB               BBBBBBBBBBB   BBBBB   B
B              BBBBBBBBBBBBB   BBBBBB  B
B                                      B
B         BBBBBBBBBBBBBBBBBBBBBBBBBBB  B
BB      BBBBBBBBBBBBBBBBBBBBBBBBBBBBB  B
BBB                            BBBBBB  B
BBBB                           BBBBBB  B
BBBBBBBBBBBBBBB          BBBBBBBBBBBB  B
B    BBBBBBBBBBBB         BBBBBBBBBBB  B
B     BBBBBBBBBBBBB       BBBBBBBBBB   B
BB            BBBBBBB       BBBBBBB    B
BBB            BBBBBBBB   BBBBBBB      B
BBB                                    B
BBBBBBBBBBBBBBBBBBBBBBBBBBBBBBBBBBBBBBBB